NO ./scenes/textures/retro/CONSOLE_1A.png
WE ./scenes/textures/retro/CONSOLE_1B.png
SO ./scenes/textures/retro/CONSOLE_1C.png
EA ./scenes/textures/retro/CONSOLE_1D.png

F 20,40,80
C 220,200,180

1111
1001
10N1
1111
