NO ./scenes/textures/retro/CONCRETE_2A.png
WE ./scenes/textures/retro/CONCRETE_2B.png
SO ./scenes/textures/retro/CONCRETE_3A.png
EA ./scenes/textures/retro/CONCRETE_3B.png

F 120,50,50
C 50,120,50

111111111111111111111111111111111
100000000000000000000000000000001
101111111000101100110110111111101
101000001010001011110110100000101
101011101000100110100100101110101
101011101000101111011110101110101
101011101011001010000100101110101
101000001001010100001100100000101
101111111010101010101010111111101
100000000001000110111110000000001
101010101000010011010000001001001
100000010001110011010000100100101
100101001110100100010001101011101
100110010000010001011010000001001
100001001110001000100000110101101
101110110001100101101011100100101
101100111011100011101001011101101
100000100101010110110101100101001
1000N0101011001011010001110101101
100111110111001011010111100110101
101001101000101100011010110001101
100100000010101001011111101101001
101001111111110000100011111000001
100000000010110101111110001011101
101111111000110011101110101101101
101000001001011110111010001101001
101011101010111011001011111001001
101011101000011111000010011010001
101011101010001100010100011100101
101000001000110001000110000001001
101111111010010000100011100101101
100000000000000000000000000000001
111111111111111111111111111111111
